01111111111B
010000000001
010111111101
010100000101
011101111101
000101000001
A11101111111